NO ./textures/dungeon_wall.png
SO ./textures/dungeon_wall.png
WE ./textures/dungeon_wall2.png
EA ./textures/dungeon_wall2.png

C 42,44,52
F 32,34,42

1111111111111111111111111
1E00001000000001000000001
1111001001111111001001111
1000000001000001001001001
1001111001001001111001001
1000001001001000000001001
1001111001111001111001001
1000001000000001001000001
1111111111001001001111001
1001001001001000000001001
1001001001111001001001001
1000000001000001001001001
1001111111111001111111001
1000001001000001000001001
1001001001001012000001001
100100000000100100000D001
1111111111111111111111111
