NO ./textures/north_ko.png
SO ./textures/south_ko.png
WE ./textures/west_ko.png
EA ./textures/east_ko.png

C 181,227,229
F 136,126,94

        1111111111111111111111111
        1000000000110000000000001
        101100000110000000000001
        1001000000000000000000001
111111111011000001110000000000001
1000000000110000011101111020011111
11110111111111011100000010001    111
11110111111111011101010010001
11000000110101011100000000001
100000000000000011000001D1N01
100000000000000011010100010001
1100000111010101111101111000111
11110111 1110101 101111010001
11111111 1111111 11111111111
