NO ./textures/north.png
SO ./textures/south.png
WE ./textures/west.png
EA ./textures/east.png

C 225,30,0
F 220,100,0

11111111
10000001
10001001
10000001
10000001
10000001
10000001
10000001
10000001
10000001
10010001
10100001
10000001
10000001
10000001
10000001
10000001
10000001
10000001
10000001
10000001
10000001
10000001
10000E01
11111110
