NO ./textures/north.png
SO ./textures/south.png
WE ./textures/west.png
EA ./textures/east.png

C 225,30,0
F 220,100,0


1                   1
      11111111
      10000001
      100N0001
      11111111
1
1
1
1
1
1
1
1
1                     1
