NO ./textures/north.png
SO ./textures/south.png
WE ./textures/west.png
EA ./textures/east.png

C 225,30,0
F 220,100,0

        11111111
        10000001
        100N0001
1111111110000001
1000000000000001
1000000000000001
1111111110000001
        10000001
        100000011111
        100000000001
        100000000001
        111111111111
